09, 03, 03, 03, 03, 03, 04, 03, 03, 03, 03, 07
02, 01, 01, 01, 01, 01, 13, 01, 01, 01, 01, 02
02, 01, 01, 01, 01, 01, 01, 01, 01, 01, 01, 02
02, 01, 01, 01, 01, 01, 01, 01, 01, 01, 01, 02
02, 01, 01, 01, 01, 01, 01, 01, 01, 01, 01, 02
02, 01, 01, 01, 01, 01, 01, 01, 01, 01, 01, 02
02, 01, 01, 01, 01, 01, 01, 01, 01, 01, 01, 02
02, 01, 01, 01, 01, 01, 01, 01, 01, 01, 01, 02
02, 01, 01, 01, 01, 01, 01, 01, 01, 01, 01, 02
02, 01, 01, 01, 01, 01, 01, 01, 01, 01, 01, 02
02, 01, 01, 01, 01, 01, 01, 01, 01, 01, 01, 02
02, 01, 01, 01, 01, 01, 01, 01, 01, 01, 01, 02
02, 01, 01, 01, 01, 01, 01, 01, 01, 01, 01, 02
04, 12, 01, 01, 01, 01, 01, 01, 01, 01, 01, 02
02, 01, 01, 01, 01, 01, 01, 01, 01, 01, 01, 02
02, 01, 01, 01, 01, 01, 01, 01, 01, 01, 01, 02
02, 01, 01, 01, 01, 01, 01, 01, 01, 01, 01, 02
02, 01, 01, 01, 01, 01, 01, 01, 01, 01, 01, 02
02, 01, 01, 01, 01, 01, 01, 01, 01, 01, 01, 02
02, 01, 01, 01, 01, 01, 01, 01, 01, 01, 01, 02
08, 03, 03, 03, 03, 03, 03, 03, 03, 03, 03, 06